14 0
1000 10 10 5 10 0 0 0 0 0
50 20 0 1 1
70 15 2 2 2
100 20 5 3 3
110 25 5 5 4
200 35 10 5 5
150 40 20 8 6
125 50 25 10 7
150 65 30 10 8
300 75 45 13 10
400 90 50 15 12
500 115 65 15 15
250 120 70 17 17
450 150 90 19 19
550 160 90 20 20
100 200 110 25 25
700 250 125 30 30
1300 300 150 35 35
850 350 200 40 40
500 400 260 45 45
900 450 330 50 50
1250 500 400 55 55
1500 560 460 60 60
1200 620 520 75 75
2000 680 590 65 65
900 750 650 70 70
1500 830 730 70 70
2500 900 850 75 75
1200 980 900 75 75
3100 1150 1050 80 80
15000 1000 1000 100 100
150 400 1000 3 10 
0 0 4 0 0 1 1 0 0 2 3 0 0 3 3 7 0 4 1 0 0 5 3 7 0 6 3 5 0 7 1 0 0 9 3 0 0 10 3 0 1 1 1 0 1 3 2 3 1 4 5 0 1 5 2 5 1 7 5 0 1 8 2 5 1 9 3 1 2 0 3 7 2 1 1 0 2 2 2 3 2 3 3 3 2 4 1 0 2 6 3 8 2 7 1 0 2 9 3 7 2 10 3 7 3 0 2 0 3 1 1 0 3 2 5 0 3 3 1 0 3 4 1 0 3 5 1 0 3 6 1 0 3 7 1 0 3 8 1 0 3 9 1 0 3 10 1 0 4 0 2 1 4 1 1 0 4 8 1 0 4 10 3 8 5 0 2 0 5 1 1 0 5 2 1 0 5 3 1 0 5 4 1 0 5 5 5 0 5 6 1 0 5 8 5 0 5 9 3 7 6 1 1 0 6 2 3 0 6 3 3 0 6 4 1 0 6 5 2 6 6 6 1 0 6 8 1 0 6 10 3 9 7 1 1 0 7 2 3 9 7 3 3 9 7 4 1 0 7 5 2 0 7 6 1 0 7 8 1 0 7 9 1 0 7 10 1 0 8 1 1 0 8 2 3 0 8 3 3 0 8 4 2 4 8 5 2 2 8 6 1 0 8 8 1 0 8 9 3 7 8 10 3 7 9 1 1 0 9 2 1 0 9 3 1 0 9 4 1 0 9 5 1 0 9 6 1 0 9 8 5 0 9 9 2 8 9 10 3 8 10 8 1 0 10 9 3 7 10 10 3 7 -1
0 0 4 1 0 10 4 0 1 0 1 0 1 1 1 0 1 2 1 0 1 3 1 0 1 4 1 0 1 5 1 0 1 6 5 2 1 7 1 0 1 8 1 0 1 9 1 0 1 10 1 0 2 1 3 5 2 2 3 7 2 3 3 7 2 5 5 0 2 7 5 0 2 8 3 7 2 9 3 7 2 10 3 3 3 0 2 24 3 1 1 0 3 2 1 0 3 3 1 0 3 4 1 0 3 5 1 0 3 7 1 0 3 8 1 0 3 9 1 0 3 10 1 0 4 1 3 1 4 2 3 7 4 3 3 7 4 5 1 0 4 7 1 0 4 8 3 0 4 9 3 0 4 10 3 0 5 0 1 0 5 1 1 0 5 2 1 0 5 3 1 0 5 5 5 0 5 7 5 1 5 8 3 1 5 9 3 1 5 10 3 1 6 0 3 3 6 1 3 3 6 2 3 3 6 3 1 0 6 5 1 0 6 6 1 0 6 7 1 0 6 8 1 0 6 9 1 0 6 10 1 0 7 0 3 5 7 1 3 5 7 2 3 5 7 3 1 0 7 4 5 0 7 5 1 0 8 0 3 7 8 1 3 7 8 2 3 7 8 3 1 0 8 5 5 0 8 6 2 17 8 7 1 0 8 8 1 0 8 9 1 0 8 10 1 0 9 0 3 9 9 1 3 8 9 2 2 17 9 3 5 0 9 5 1 0 10 0 1 0 10 1 1 0 10 2 1 0 10 3 1 0 10 4 1 0 10 5 1 0 10 6 1 0 10 7 1 0 10 8 1 0 10 9 1 0 10 10 1 0 -1
0 0 3 4 0 1 2 1 0 2 3 7 0 3 1 0 0 5 2 0 0 6 2 0 0 8 1 0 0 9 1 0 0 10 4 1 1 0 2 1 1 1 3 7 1 2 2 3 1 3 5 0 1 5 1 0 1 6 1 0 1 8 1 0 2 0 3 7 2 3 1 0 2 6 1 0 2 8 1 0 2 10 1 0 3 0 1 0 3 1 1 0 3 2 1 0 3 3 1 0 3 4 1 0 3 5 2 2 3 6 1 0 3 8 1 0 3 10 1 0 4 2 1 0 4 4 1 0 4 5 2 1 4 6 1 0 4 8 2 2 4 10 1 0 5 0 6 0 5 2 5 0 5 3 2 3 5 4 1 0 5 5 2 2 5 6 1 0 5 7 1 0 5 8 1 0 5 9 1 0 5 10 1 0 6 2 1 0 6 7 1 0 6 8 2 1 6 9 3 3 6 10 3 5 7 0 1 0 7 1 1 0 7 2 1 0 7 3 1 0 7 4 1 0 7 5 1 0 7 7 5 0 7 9 2 2 7 10 3 1 8 0 1 0 8 3 3 7 8 4 3 7 8 5 3 7 8 7 1 0 8 8 2 1 8 9 3 7 8 10 3 7 9 0 1 0 9 1 2 2 9 2 1 0 9 3 1 0 9 4 1 0 9 5 1 0 9 6 1 0 9 7 1 0 9 8 1 0 9 9 1 0 9 10 1 0 10 0 1 0 10 3 2 1 10 4 2 2 10 5 2 1 10 10 4 0 -1
0 1 5 0 0 4 2 2 0 5 2 2 0 6 2 1 0 10 4 0 1 0 2 4 1 1 1 0 1 2 1 0 1 3 1 0 1 4 1 0 1 5 1 0 1 6 1 0 1 7 1 0 1 8 1 0 1 9 1 0 1 10 1 0 2 1 5 0 2 3 2 3 2 4 3 0 2 5 3 0 3 0 1 0 3 1 1 0 3 2 1 0 3 3 1 0 3 4 1 0 3 5 1 0 3 6 1 0 3 7 1 0 3 8 1 0 3 9 1 0 3 10 2 4 4 2 1 0 4 3 2 7 4 4 3 5 4 5 1 0 4 6 2 8 4 7 3 3 4 8 1 0 4 9 3 7 5 3 2 13 5 4 2 7 5 5 5 2 5 6 2 12 5 7 2 8 5 8 5 1 6 2 1 0 6 3 2 7 6 4 3 5 6 5 1 0 6 6 2 8 6 7 3 3 6 8 1 0 6 9 3 7 7 0 1 0 7 1 1 0 7 2 1 0 7 3 1 0 7 4 1 0 7 5 1 0 7 6 1 0 7 7 1 0 7 8 1 0 7 9 1 0 7 10 2 4 8 1 5 0 8 3 2 3 8 4 3 0 8 5 3 0 9 0 2 4 9 1 1 0 9 2 1 0 9 3 1 0 9 4 1 0 9 5 1 0 9 6 1 0 9 7 1 0 9 8 1 0 9 9 1 0 9 10 1 0 10 1 5 0 10 4 2 2 10 5 2 2 10 6 2 1 10 10 4 1 -1
0 0 3 9 0 1 3 8 0 2 2 7 0 4 2 7 0 5 3 3 0 6 3 5 0 8 1 0 0 10 4 1 1 0 1 0 1 1 1 0 1 2 1 0 1 3 5 0 1 4 1 0 1 5 1 0 1 6 1 0 1 7 6 1 1 8 1 0 2 0 3 0 2 1 3 3 2 3 2 6 2 6 1 0 2 7 1 0 2 8 1 0 2 9 1 0 3 0 1 0 3 1 1 0 3 2 1 0 3 3 1 0 3 4 1 0 3 6 2 4 3 7 2 4 3 8 2 2 4 0 3 7 4 1 2 6 4 2 2 5 4 3 3 8 4 4 1 0 4 6 1 0 4 7 1 0 4 8 1 0 4 9 1 0 5 0 2 6 5 3 2 5 5 4 1 0 5 5 2 2 5 6 1 0 6 2 1 0 6 3 1 0 6 4 1 0 6 5 2 3 6 6 1 0 6 8 1 0 6 9 1 0 6 10 1 0 7 2 1 0 7 6 1 0 7 7 2 2 7 8 5 1 7 9 3 7 7 10 3 5 8 0 2 6 8 2 5 0 8 3 2 8 8 7 2 8 8 8 1 0 8 9 5 0 8 10 1 0 9 0 3 5 9 1 2 6 9 2 1 0 9 3 2 5 9 7 2 12 9 8 5 0 9 10 4 0 10 0 3 5 10 1 3 5 10 2 1 0 10 4 2 5 10 8 1 0 10 9 1 0 10 10 1 0 -1
0 1 2 9 0 2 3 7 0 4 1 0 1 0 2 9 1 1 3 7 1 2 2 13 1 4 1 0 1 6 1 0 1 7 1 0 1 8 1 0 1 9 1 0 2 0 1 0 2 1 1 0 2 2 5 1 2 3 1 0 2 4 1 0 2 5 2 14 2 6 1 0 2 7 2 7 2 8 5 0 2 9 2 7 3 0 3 5 3 1 3 3 3 3 2 12 3 4 5 2 3 6 1 0 3 7 5 0 3 8 1 0 3 9 1 0 3 10 1 0 4 0 1 0 4 1 1 0 4 2 5 1 4 3 1 0 4 4 1 0 4 5 3 7 4 6 1 0 4 7 2 7 4 8 5 0 4 10 4 0 5 0 3 7 5 2 2 13 5 4 1 0 5 5 3 7 5 6 1 0 5 8 1 0 6 0 2 15 6 1 3 7 6 4 1 0 6 5 3 7 6 6 1 0 6 8 1 0 6 9 1 0 6 10 5 0 7 1 2 15 7 2 3 7 7 4 1 0 7 6 1 0 7 8 1 0 7 9 1 0 7 10 5 0 8 0 1 0 8 1 1 0 8 2 1 0 8 3 1 0 8 4 1 0 8 5 2 14 8 6 1 0 8 8 1 0 9 0 3 1 9 1 2 10 9 3 2 18 9 4 5 0 9 6 1 0 9 8 5 1 9 10 4 1 10 0 3 1 10 1 3 1 10 2 2 10 10 4 1 0 10 6 1 0 10 7 1 0 10 8 1 0 10 9 1 0 10 10 1 0 -1
0 0 4 0 0 1 1 0 0 2 1 0 0 10 1 0 1 1 1 0 1 5 1 0 1 6 1 0 1 7 1 0 1 8 1 0 2 2 2 13 2 3 1 0 2 4 5 1 2 5 1 0 2 6 3 0 2 7 3 7 2 8 1 0 2 9 1 0 3 1 2 13 3 2 3 5 3 3 1 0 3 4 2 16 3 5 1 0 3 6 3 3 3 7 3 0 3 8 3 8 3 9 1 0 3 10 5 0 4 1 1 0 4 2 1 0 4 3 1 0 4 5 1 0 4 6 1 0 4 7 1 0 4 8 3 8 4 9 1 0 4 10 4 1 5 1 5 1 5 2 2 16 5 6 2 16 5 7 5 1 5 8 3 1 5 9 5 2 6 1 1 0 6 2 1 0 6 3 1 0 6 5 1 0 6 6 1 0 6 7 1 0 6 8 3 8 6 9 1 0 7 1 2 9 7 2 3 3 7 3 1 0 7 4 2 16 7 5 1 0 7 6 3 5 7 7 3 0 7 8 3 8 7 9 1 0 7 10 5 0 8 0 1 0 8 2 2 9 8 3 1 0 8 4 5 1 8 5 1 0 8 6 3 0 8 7 3 7 8 8 1 0 8 9 1 0 9 0 1 0 9 1 1 0 9 5 1 0 9 6 1 0 9 7 1 0 9 8 1 0 10 0 1 0 10 1 1 0 10 2 1 0 10 10 1 0 -1
0 0 4 1 0 4 2 7 0 5 2 13 0 6 2 7 1 0 1 0 1 1 1 0 1 2 1 0 1 3 1 0 1 4 1 0 1 5 1 0 1 6 1 0 1 7 1 0 1 8 1 0 1 9 1 0 2 5 3 5 2 6 2 4 2 7 2 4 2 9 1 0 2 10 2 11 3 1 1 0 3 2 1 0 3 3 1 0 3 4 1 0 3 5 1 0 3 6 1 0 3 7 1 0 3 8 2 9 3 9 1 0 4 1 1 0 4 4 3 0 4 5 3 0 4 7 1 0 4 9 5 0 5 1 5 0 5 3 1 0 5 4 1 0 5 5 1 0 5 7 1 0 5 8 1 0 5 9 1 0 5 10 1 0 6 0 1 0 6 1 1 0 6 2 5 1 6 3 1 0 6 4 4 0 6 5 1 0 6 7 2 12 6 8 2 9 7 1 5 0 7 3 1 0 7 5 1 0 7 6 1 0 7 7 1 0 7 8 1 0 7 9 1 0 7 10 2 15 8 0 3 9 8 1 1 0 8 3 2 7 8 5 1 0 8 7 5 0 8 9 1 0 8 10 2 16 9 0 2 9 9 1 1 0 9 2 1 0 9 3 1 0 9 4 1 0 9 5 1 0 9 6 2 13 9 7 1 0 9 9 1 0 9 10 2 15 10 2 3 3 10 3 2 4 10 4 2 4 10 7 1 0 -1
0 1 3 7 0 2 1 0 0 5 1 0 0 6 3 3 0 7 1 0 0 8 2 9 0 9 3 8 1 0 3 7 1 2 5 0 1 5 5 1 1 6 2 18 1 7 5 0 1 8 3 0 1 9 2 9 1 10 3 8 2 1 2 19 2 2 1 0 2 5 1 0 2 6 3 5 2 7 1 0 2 8 2 9 2 9 3 0 2 10 2 9 3 0 1 0 3 1 5 0 3 2 1 0 3 3 1 0 3 4 5 2 3 5 1 0 3 6 1 0 3 7 1 0 3 8 1 0 3 9 1 0 3 10 5 0 4 0 1 0 4 6 2 11 4 8 1 0 4 9 2 10 4 10 3 1 5 0 1 0 5 2 1 0 5 3 1 0 5 4 1 0 5 5 1 0 5 6 1 0 5 8 5 1 5 9 2 11 5 10 2 10 6 2 1 0 6 4 4 1 6 5 1 0 6 6 4 0 6 8 1 0 6 9 2 10 6 10 3 1 7 1 1 0 7 2 1 0 7 4 1 0 7 5 1 0 7 6 1 0 7 7 5 0 7 8 1 0 7 9 1 0 7 10 1 0 9 0 1 0 9 1 5 0 9 2 1 0 9 3 1 0 9 4 1 0 9 5 1 0 9 6 1 0 9 7 1 0 9 8 1 0 9 9 5 0 9 10 1 0 10 1 2 9 10 2 3 7 10 3 3 7 10 4 3 0 10 5 1 0 10 6 3 0 10 7 3 7 10 8 3 7 10 9 2 9 -1
0 4 2 7 0 5 2 13 0 6 2 7 0 10 4 0 1 0 1 0 1 3 1 0 1 4 1 0 1 5 1 0 1 6 1 0 1 7 1 0 1 8 1 0 1 9 1 0 1 10 1 0 2 0 1 0 2 1 1 0 2 7 1 0 2 8 3 0 2 9 3 0 2 10 3 0 3 0 3 5 3 1 1 0 3 3 1 0 3 5 1 0 3 7 1 0 3 8 3 5 3 9 3 5 3 10 3 5 4 0 2 19 4 1 5 0 4 3 1 0 4 4 3 7 4 5 1 0 4 7 1 0 4 8 3 3 4 9 3 3 4 10 3 3 5 0 1 0 5 1 1 0 5 2 1 0 5 3 1 0 5 4 3 7 5 5 1 0 5 7 1 0 5 8 1 0 5 9 5 2 5 10 1 0 6 0 2 19 6 1 5 0 6 3 1 0 6 4 3 7 6 5 1 0 6 6 4 1 6 7 1 0 6 9 2 11 6 10 3 8 7 0 3 3 7 1 1 0 7 3 1 0 7 5 5 0 7 7 5 0 7 8 2 13 7 9 1 0 7 10 1 0 8 0 1 0 8 1 1 0 8 5 1 0 8 6 5 0 8 7 1 0 8 9 2 11 8 10 3 8 9 0 1 0 9 2 2 18 9 3 1 0 9 4 1 0 9 5 1 0 9 6 2 13 9 7 1 0 9 8 1 0 9 9 1 0 9 10 1 0 10 1 2 18 10 3 1 0 10 4 3 7 10 5 3 7 10 8 3 7 10 9 3 7 10 10 3 0 -1
0 0 3 0 0 1 3 0 0 2 3 0 0 3 5 0 0 5 5 0 0 6 3 5 0 7 3 5 0 8 3 5 0 9 1 0 0 10 4 1 1 0 1 0 1 1 1 0 1 2 1 0 1 3 1 0 1 5 1 0 1 6 1 0 1 7 1 0 1 8 1 0 1 9 1 0 2 0 3 7 2 1 3 7 2 2 3 7 2 3 5 0 2 5 1 0 2 7 2 19 2 8 2 19 2 9 5 2 3 0 1 0 3 1 1 0 3 2 1 0 3 3 1 0 3 5 5 1 3 6 2 20 3 7 1 0 3 8 1 0 3 9 1 0 4 0 3 8 4 1 3 8 4 2 3 8 4 3 5 0 4 5 1 0 4 7 1 0 4 9 3 0 5 0 1 0 5 1 1 0 5 2 1 0 5 3 1 0 5 4 1 0 5 5 1 0 5 6 2 22 5 7 1 0 6 0 3 9 6 1 3 9 6 2 3 9 6 3 5 0 6 5 1 0 6 7 1 0 6 9 3 0 7 0 1 0 7 1 1 0 7 2 1 0 7 3 1 0 7 5 5 1 7 6 2 20 7 7 1 0 7 8 1 0 7 9 1 0 8 0 3 1 8 1 2 20 8 3 1 0 8 5 1 0 8 7 2 19 8 8 2 19 8 9 5 2 9 1 2 21 9 2 2 20 9 3 5 1 9 5 1 0 9 6 1 0 9 7 1 0 9 8 1 0 9 9 1 0 10 0 3 1 10 1 2 20 10 3 1 0 10 5 5 0 10 6 3 3 10 7 3 3 10 8 3 3 10 9 1 0 10 10 4 0 -1
0 1 3 3 0 4 2 22 0 5 1 0 0 7 1 0 0 8 3 5 0 9 1 0 0 10 4 0 1 0 3 5 1 3 2 22 1 4 2 23 1 5 5 1 1 7 1 0 1 8 2 22 1 9 1 0 2 0 1 0 2 1 1 0 2 2 1 0 2 3 1 0 2 4 1 0 2 5 1 0 2 7 1 0 2 8 5 0 2 9 1 0 3 8 2 20 3 9 1 0 4 0 2 17 4 1 1 0 4 2 1 0 4 3 1 0 4 4 1 0 4 5 1 0 4 6 1 0 4 7 1 0 4 8 2 20 4 9 1 0 5 0 2 24 5 1 5 0 5 2 2 24 5 3 3 7 5 4 3 7 5 5 3 0 5 6 3 0 5 7 1 0 5 8 2 21 5 9 5 1 6 0 2 17 6 1 1 0 6 2 1 0 6 3 1 0 6 4 1 0 6 5 1 0 6 6 1 0 6 7 1 0 6 8 2 20 6 9 1 0 7 8 2 20 7 9 1 0 8 0 1 0 8 1 1 0 8 2 1 0 8 3 1 0 8 4 1 0 8 5 1 0 8 7 1 0 8 8 5 0 8 9 1 0 9 0 3 1 9 3 2 27 9 4 2 25 9 5 5 1 9 7 1 0 9 8 2 22 9 9 1 0 10 1 3 1 10 4 2 27 10 5 1 0 10 7 1 0 10 8 3 3 10 9 1 0 10 10 4 1 -1
0 3 3 1 0 4 2 17 0 5 2 24 0 6 2 17 0 9 1 0 0 10 4 1 1 0 2 22 1 1 1 0 1 2 1 0 1 3 1 0 1 4 1 0 1 5 1 0 1 6 1 0 1 7 1 0 1 8 2 17 1 9 1 0 2 1 1 0 2 3 5 2 2 6 2 23 2 7 1 0 3 1 1 0 3 3 1 0 3 5 2 26 3 7 1 0 3 8 1 0 3 9 1 0 3 10 5 1 4 1 1 0 4 2 2 20 4 3 1 0 4 4 2 23 4 7 1 0 4 9 3 1 5 1 1 0 5 3 1 0 5 4 1 0 5 5 1 0 5 6 1 0 5 7 1 0 5 9 1 0 5 10 4 0 6 1 5 0 6 4 2 20 6 5 2 21 6 6 2 20 6 9 1 0 6 10 1 0 7 0 1 0 7 1 1 0 7 2 1 0 7 3 1 0 7 4 1 0 7 5 1 0 7 6 1 0 7 7 1 0 7 8 2 23 7 9 1 0 8 4 3 3 8 5 3 3 8 6 3 3 8 9 1 0 8 10 2 26 9 0 2 23 9 1 1 0 9 2 1 0 9 3 1 0 9 4 1 0 9 5 1 0 9 6 1 0 9 7 1 0 9 8 1 0 9 9 1 0 9 10 5 0 10 6 3 5 10 7 3 5 10 8 3 5 -1
0 0 1 0 0 1 1 0 0 2 1 0 0 3 1 0 0 4 1 0 0 5 1 0 0 6 1 0 0 7 1 0 0 8 1 0 0 9 1 0 0 10 1 0 1 9 2 20 1 10 1 0 2 1 3 1 2 2 1 0 2 3 1 0 2 4 1 0 2 5 1 0 2 6 3 0 2 9 2 21 2 10 1 0 3 0 2 27 3 1 1 0 3 2 1 0 3 6 1 0 3 9 2 20 3 10 1 0 4 1 1 0 4 2 1 0 4 3 1 0 4 4 1 0 4 5 1 0 4 6 1 0 4 7 1 0 4 8 1 0 4 9 5 1 4 10 1 0 5 0 4 0 5 1 1 0 5 2 1 0 5 5 2 23 5 6 2 26 5 7 2 23 5 8 5 1 5 10 4 1 6 1 1 0 6 2 1 0 6 3 1 0 6 4 1 0 6 5 1 0 6 6 1 0 6 7 1 0 6 8 1 0 6 9 5 1 6 10 1 0 7 1 1 0 7 2 1 0 7 6 1 0 7 9 2 20 7 10 1 0 8 1 3 1 8 2 1 0 8 3 1 0 8 4 1 0 8 5 1 0 8 6 3 0 8 9 2 21 8 10 1 0 9 9 2 20 9 10 1 0 10 0 1 0 10 1 1 0 10 2 1 0 10 3 1 0 10 4 1 0 10 5 1 0 10 6 1 0 10 7 1 0 10 8 1 0 10 9 1 0 10 10 1 0 -1
